1111111111111111111111
1000000000000000000001
1010011101111110111101
101C000010000010000101
1000011101111110111101
1000000000000000000001
1110111110000111011101
1P00100000C00001000001
1111010111110111101111
1000000100000100000001
1010011111000111111101
1010000000000000000E01
1111111111111111111111