11111111111111111111111111111111111111111111111111111111111111111111111111111
11111111111111110000000000000000000000000000000000000000111111111111111111111
11111111111111110111111111111111111111111111111111111111111111111111111111111
111111111111111101C00000000E0000000000000P0000000000C000111111111111111111111
11111111111111110111011111111111111111111111111111111111111111111111111111111
11111111111111110000000000000000000000000000000000000000111111111111111111111
11111111111111110111111111111111111111111111111111111111111111111111111111111
11111111111111110000000000000000000000000000000000000000111111111111111111111
11111111111111110000000000000000000000000000000000000000111111111111111111111
11111111111111110111111111111111111111111111111111111111111111111111111111111
11111111111111110000000000000000000000000000000000000000111111111111111111111
11111111111111110000000000000000000000000000000000000000111111111111111111111
11111111111111110111111111111111111111111111111111111111111111111111111111111
11111111111111110000000000000000000000000000000000000000111111111111111111111
11111111111111110111111111111111111111111111111111111111111111111111111111111
11111111111111110000000000000000000000000000000000000000111111111111111111111
11111111111111110000000000000000000000000000000000000000111111111111111111111
11111111111111110111111111111111111111111111111111111111111111111111111111111
11111111111111110000000000000000000000000000000000000000111111111111111111111
11111111111111110000000000000000000000000000000000000000111111111111111111111
11111111111111110111111111111111111111111111111111111111111111111111111111111
11111111111111110000000000000000000000000000000000000000111111111111111111111
11111111111111110000000000000000000000000000000000000000111111111111111111111
11111111111111110111111111111111111111111111111111111111111111111111111111111
11111111111111110000000000000000000000000000000000000000111111111111111111111
11111111111111110000000000000000000000000000000000000000111111111111111111111
11111111111111110000000000000000000000000000000000000000111111111111111111111
11111111111111110111111111111111111111111111111111111111111111111111111111111
11111111111111110000000000000000000000000000000000000000111111111111111111111
11111111111111110000000000000000000000000000000000000000111111111111111111111
11111111111111110111111111111111111111111111111111111111111111111111111111111
11111111111111110000000000000000000000000000000000000000111111111111111111111
11111111111111110111111111111111111111111111111111111111111111111111111111111
11111111111111110000000000000000000000000000000000000000111111111111111111111
11111111111111110000000000000000000000000000000000000000111111111111111111111
11111111111111110111111111111111111111111111111111111111111111111111111111111
11111111111111110000000000000000000000000000000000000000111111111111111111111
11111111111111110000000000000000000000000000000000000000111111111111111111111
11111111111111110000000000000000000000000000000000000000111111111111111111111
11111111111111111111111111111111111111111111111111111111111111111111111111111