1111111111111
1000000000001
1111011111111
1P0000E0000C1
1111111111111
