1111111111111
1000C00000001
1111111101111
1P0000E0C00C1
1111111111111