111111111111111111111111111111111111111111111111111
100000000000000000000000000000000000000000000000001
1000000000000000000000000000C000000000000C000000001
100000000000000000000000000000000000000000000000001
100000000000000000000000000000P00000000000000000001
100000000000000000000000000000000000000000000000001
100000000000000000000000000000000000000000000000001
100000011111111111111000000000000C00000000000000001
100000000000000000000000000000000000000000000000001
100000000000000000000000000000000000000000000000001
100000000000000000000000000000000000000000000000001
1000000000000000000000000000000000000000000000000E1
100000000000000000000000000000000000000000000000001
100000000000000000000000000000000000000000000000001
100000000000000000000000000000000C00000000000000001
100000000000000000000000000000000000000000000000001
111111111111100000000000000000000000000000000000001
100000000000000000000000000000000000000000000000001
100000000000000000000000000000000000000000000000001
100000000000000000000000000000000000000000000000001
100000000000000000000000000000000C00000000000000001
100000001111111111100000000000000000000000000000001
100000000000000000000000000000000000000000000000001
100000000000000000000000000000011111111111111111111
100000000000000000000000000000000000000000000000001
100000000000000000000000000000000000000000000000001
100000000000000000000000000000000000000000000000001
100000000000001111000000000000000000000000000000001
100000000000000001000000000000000000000000000000001
100000000000000001000000000000000000000000000000001
100000000000000001000000000000000000000000000000001
111111111111111111111111111111111111111111111111111