1111111111111
1000000000001
1000C00000001
1110111101111
1P0000E0C00C1
1000000000001
1111111111111